111111111111111111111111111111111111111
100000000000000000000000000000100000101
101111111110111111111111111110101110101
101000000E101000000000000000101B1010101
101011111110101111111111111010111010101
101000000000100000000000001010100010101
101111111011111111111111101010100010101
100000001000000000000000101010100000101
101111101111111111111110101010101010101
101000100010000000000010101010001010101
101010111011111011111010101011111110101
101010101000001010001010101000001010101
101011101111101011101010111011101010101
101000000010101000001010100010101010101
101111101110101111111010101110101010101
100000100010100000000010101000100010101
111110111010111111111010101011111110101
100010001010000000001010100000100010101
100011101011101111101010111010111010101
100000101000001000001010001010101010101
100000101111101011111011101110111010101
100000100000101010001000100000000010101
100000111110101011101110111111111110101
100000000010101000000010000000000000101
100000000010111111101111111111111110101
100000000010000000100000000000000000101
100000000011111110111111111111111111101
100000000000000010000000000000000000101
100000000000000011101111111111111110101
100000000000000000101000000000000010101
100000000000000000101011111111111010101
10000000000000000010101H000000001010101
100000000000000011101011101111101010101
100000000000000010001000101000101010101
100000000000000011101110101011101010111
100000000000000000100010100010001010001
100000000000000000111010111110111010001
100000000000000000001010000010100010001
100000000000000011101011111010101110001
10000000000000001F101000001010101000001
100000000000000010101111101010101011101
100000000000000010100000101000101010101
100000000000000010111000101111101011101
100000000000000010001000100000001000001
100000000000000011101111111111111000001
100000000000000000100000000010000000001
100000000000000000111111111010111111101
100000000000000000000000101000100000101
100000000000000000000000101110101110101
100000000000000000000000100000101010101
100000000000000000000000111110111010101
100000000000000000000000000010100010001
100000000000000000000000000011100010111
100000000000000000000000000000000010101
111111111111111111111111111111111111111
