1111111111111111111111111111111111111111111111111111111
1000000000000000000000001000001000000000000000000000001
10000000000000000011111110G0111111111000000000000000001
1000000000000000001000100000000010001000000000000000001
1000000000000011111110101111111110101111100000000000001
1000000000000010000000101000100000101000100000000000001
1000000000111110111110101010101011101010111110000000001
1000000000100000100010100010101010001010100010000000001
1000000011111111101010101110111010111010101011100000001
1000000010000010001010100010100010100010101000100000001
1000001110111010111010101010101110101110111110111000001
1000001000100010001000101010001000001000100000101000001
1000001010101111101111111011111011111111101110101000001
1000001010100000001000001000001000000010101010001000001
1000111110111111111011101111101111111010101010111110001
1000100000100000000010001000101000100010101000100010001
1000101111101110111110111010111010101110101111101110001
1000100010001000101000100010001010001000001000000010001
1011101011111110101011101111101010101011111111111011101
1010001000100000101010001000100010101010000000001000101
1010111110101111101010101010111110111010111111101010101
1010100000001000001000100010001000000010100000100010101
1010101111111011111111111111101011111110101110111110101
1010101000001000100000000000101000000010101000100010101
1111101011101010101111111110101111111010101111101011111
1000001005101010001000000000001010001010000010001000101
1010111111101111111011111111111010101111111010111110101
1010100010000010000010000000100010101000001010100000001
1011101010111010101110111110111010111010111010111111111
1000101000101010101000100000001010000010100010000000001
1110101111101010101011101011101010111010101111111110111
1010101000101010100010001000100010001010100010000010101
1010101010101010111110111110101110101010111010111010101
1010100010001000100000100000100000101010100010001000101
1010111011111111101111101111111111111010101111101111101
1010001000000000101000100000000000100010001000000000101
1011101011111010101010111111111110101011111111101111101
1000101010001010100010000000001000101000000000100010001
1000101110101010111111111111101111101111101110111010001
1000100010100010001000001000001000001000101000100010001
1000111011101111111011101011111011111010111011101110001
1000001000101000001000100010100010001010001000001000001
1000001010101011101111111110101110101011101111101000001
1000001010101000101000000010100000100010000000101000001
1000001110111111101010111010111011111111111110111000001
1000000010000010001010001010101010000000101000100000001
1000000011111010111011101010101010111110101011100000001
1000000000100010100000101010001000000010100010000000001
1000000000111110111110111010111111111110111110000000001
1000000000000010000010001000100010000000100000000000001
1000000000000011111011101110101010111111100000000000001
1000000000000000001000001000101000001000000000000000001
1000000000000000001111111011101111111000000000000000001
10000000000000000000000010000F1000000000000000000000001
1111111111111111111111111111111111111111111111111111111
