1111111111111111111111111111111111111111111111111111111
1000000000000000000000001G00001000000000000000000000001
1000000000000000001110111000111111111000000000000000001
1000000000000000001000000000000010001000000000000000001
1000000000000011111111101111111110101111100000000000001
1000000000000010000000101000100000001000100000000000001
1000000000111110111110101010101010101010111110000000001
1000000000100000100010100010101010001010100010000000001
1000010011111111101010111110111010111010101011100000001
1001000000100000000000000011100010100010100000100000001
1001000100000000000000000010101110101110110110111000001
1000001000010001000000000010001000001000100000101000001
1001000001000100000000000010010011111111101110101000001
1000100000100101000000000010001000000000101010001000001
1010001001000000111000001111101111111010101010111110001
1001000010010000001000001000101000100010101000100010001
1001111000001001010000001010111010101110101111101110001
1000011000100100100000001010001010001000001000000010001
1001001110000010010000111011101010101011111111111011101
1000000010110011000000100000100010101010000000001000101
1001111001001001100000101110111110111010111111101010101
1000000000010000110000101010001000000010100000100010101
1001111000001000010000101011101011111110101110111110101
1000000000001111100000101000000000000010101000100010101
1000000000000000000001111000001111111010101111101011111
10000000000000000000000000000010100010100000100010001H1
1000000000000000000000101111111010101111111010111110101
1000111111100000000000101000100010101000001010100000001
1000100000100011111000111010111010111010111010111111111
1000100100100010001000001000001010000010100000000000001
1000111100100010101001101011101010111010101111111110111
1000000000000010101000100000100010001010100010000010101
1000000000000010111000101010101110101010111010111010101
1000000000000010000000101000100000101010000010001000101
1111111111111111111111111111111111111111111111111111111
