1111111111111111111
1000000010001000001
1000001110001110001
1000001000000010001
1000111110101111101
1000100010101000101
101110D010101010111
1120000000101010001
1011111111101A10001
1000100000001110001
1111111011100000111
10000E1010100000101
1011111011100011101
1010000000000010001
1011111110001110001
1000000010001000001
1111110010111000001
1010000010100000001
1010111110100000001
1010100000100000001
1010111110100000001
1010001000100000001
1110111011100000001
1000100010000000001
1011101110000000001
1000101000000000001
1110101110000000001
1010000010000000001
1011101110000000001
1000101000000000001
1111111111111111111
