11111111111111111
10001000001010001
10101011111010001
10101010000200001
10101011111111101
101A1000000000001
10111000110101001
10000001000000101
11111111110011111
1000010010001B001
10C10100000110101
11100100100010001
10100100000011101
10000000100000001
11111111111111111
